48
11


B
###T#
   ###  ######TTT## #
            ######   ##  ##

                             ##         g
     ##      ##       #    #####   #   ##
    ###  #               #######
@  ####LL## Ts  T#LLL# ###    ##TTTTTTTTTTTTTTT