48
11
###############################################

B  T
#####
     #  ######TTT## #
            ######   ##  #
                           #
                              ##        g
     ##      ##       #    #####   #   ##
    ###  #       s       #######
@  ####LL## T   T#LLL# ###    ##TTTTTTTTTTTTTTT